material processing	LABEL=MaterialProcessing	ID=DEB_ont.MaterialProcessing
has_alternative_id	LABEL=MaterialProcessing	ID=deb_ont.has_alternative_id	PrefSynonym=material processing	
architectural organization	LABEL=ManufacturedObjectFeatures	ID=DEB_ont.ArchitecturalOrganization
structural details	LABEL=ManufacturedObjectFeatures	ID=DEB_ont.StructuralDetails
structure	LABEL=Structure	ID=DEB_ont.Structure
biomaterial	LABEL=Biomaterial	ID=DEB_ont.Biomaterial
biomaterials	LABEL=Biomaterial	ID=DEB_ont.Biomaterial	PrefSynonym=biomaterial	
has_obo_namespace	LABEL=Biomaterial	ID=deb_ont.has_obo_namespace	PrefSynonym=biomaterial	
manufactured object	LABEL=ManufacturedObject	ID=DEB_ont.ManufacturedObject
manufactured object component	LABEL=ManufacturedObjectComponent	ID=DEB_ont.ManufacturedObjectComponent
biologically active substance	LABEL=BiologicallyActiveSubstance	ID=DEB_ont.BiologicallyActiveSubstance
associated biological process	LABEL=AssociatedBiologicalProcess	ID=DEB_ont.AssociatedBiologicalProcess
biological process	LABEL=AssociatedBiologicalProcess	ID=DEB_ont.AssociatedBiologicalProcess	PrefSynonym=associated biological process	
study type	LABEL=StudyType	ID=DEB_ont.StudyType
effect on biological system	LABEL=EffectOnBiologicalSystem	ID=DEB_ont.EffectOnBiologicalSystem
medical application	LABEL=MedicalApplication	ID=DEB_ont.MedicalApplication
manufactured object features	LABEL=ManufacturedObjectFeatures	ID=DEB_ont.ManufacturedObjectFeatures
biomaterial type	LABEL=BiomaterialType	ID=DEB_ont.BiomaterialType
surface	LABEL=ManufacturedObjectComponent	ID=DEB_ont.Surface
experimental scaffold	LABEL=ManufacturedObject	ID=DEB_ont.ExperimentalScaffold
scaffold	LABEL=ManufacturedObject	ID=DEB_ont.ExperimentalScaffold	PrefSynonym=experimental scaffold	
scaffolds	LABEL=ManufacturedObject	ID=DEB_ont.ExperimentalScaffold	PrefSynonym=experimental scaffold	
medical device	LABEL=ManufacturedObject	ID=DEB_ont.MedicalDevice
physical property	LABEL=ManufacturedObjectFeatures	ID=DEB_ont.PhysicalProperty
degradation features	LABEL=ManufacturedObjectFeatures	ID=DEB_ont.DegradationFeatures
abdominal fascia closure	LABEL=MedicalApplication	ID=DEB_ont.AbdominalFasciaClosure
surgical procedure	LABEL=MedicalApplication	ID=DEB_ont.SurgicalProcedure
abscesses	LABEL=AdverseEffects	ID=DEB_ont.Abscesses
adverse effects	LABEL=AdverseEffects	ID=DEB_ont.AdverseEffects
adverse event	LABEL=AdverseEffects	ID=DEB_ont.AdverseEffects	PrefSynonym=adverse effects	
absorption	LABEL=ManufacturedObjectFeatures	ID=DEB_ont.Absorption
absorbable	LABEL=ManufacturedObjectFeatures	ID=deb_ont.absorbable	PrefSynonym=absorption	
acellularity	LABEL=ManufacturedObjectFeatures	ID=DEB_ont.Acellularity
acellular	LABEL=ManufacturedObjectFeatures	ID=deb_ont.acellular	PrefSynonym=acellularity	
other features	LABEL=ManufacturedObjectFeatures	ID=DEB_ont.OtherFeatures
acute inflammation	LABEL=AdverseEffects	ID=DEB_ont.AcuteInflammation
inflammatory reaction	LABEL=AdverseEffects	ID=DEB_ont.InflammatoryReaction
inflammation	LABEL=AdverseEffects	ID=DEB_ont.InflammatoryReaction	PrefSynonym=inflammatory reaction	
inflammatory response	LABEL=AdverseEffects	ID=DEB_ont.InflammatoryReaction	PrefSynonym=inflammatory reaction	
adhesion formation	LABEL=AdverseEffects	ID=DEB_ont.AdhesionFormation
adipogenesis	LABEL=AssociatedBiologicalProcess	ID=DEB_ont.Adipogenesis
adipogenic differentiation	LABEL=AssociatedBiologicalProcess	ID=DEB_ont.AdipogenicDifferentiation
cell differentiation	LABEL=AssociatedBiologicalProcess	ID=DEB_ont.CellDifferentiation
adsorption	LABEL=MaterialProcessing	ID=DEB_ont.Adsorption
adsorbed	LABEL=MaterialProcessing	ID=deb_ont.adsorbed	PrefSynonym=adsorption	
coating	LABEL=MaterialProcessing	ID=DEB_ont.Coating
coated	LABEL=MaterialProcessing	ID=deb_ont.coated	PrefSynonym=coating	
airway stent	LABEL=ManufacturedObject	ID=DEB_ont.AirwayStent
airway stenting	LABEL=MedicalApplication	ID=DEB_ont.AirwayStenting
alginate	LABEL=Biomaterial	ID=DEB_ont.Alginate
alignment	LABEL=ManufacturedObjectFeatures	ID=DEB_ont.Alignment
aligned	LABEL=ManufacturedObjectFeatures	ID=DEB_ont.Alignment	PrefSynonym=alignment	
alloy	LABEL=BiomaterialType	ID=DEB_ont.Alloy
aneurysm	LABEL=AdverseEffects	ID=DEB_ont.Aneurysm
aneurysm formation	LABEL=AdverseEffects	ID=DEB_ont.AneurysmFormation
angiogenesis	LABEL=AssociatedBiologicalProcess	ID=DEB_ont.Angiogenesis
anisotropy	LABEL=ManufacturedObjectFeatures	ID=DEB_ont.Anisotropy
mechanical property	LABEL=ManufacturedObjectFeatures	ID=DEB_ont.MechanicalProperty
mechanicalproperties	LABEL=ManufacturedObjectFeatures	ID=DEB_ont.MechanicalProperty	PrefSynonym=mechanical property	
annealing	LABEL=MaterialProcessing	ID=DEB_ont.Annealing
anti-adhesive	LABEL=ManufacturedObjectFeatures	ID=DEB_ont.Anti-adhesive
antibacterial effect	LABEL=EffectOnBiologicalSystem	ID=DEB_ont.AntibacterialEffect
antibacterial	LABEL=EffectOnBiologicalSystem	ID=deb_ont.antibacterial	PrefSynonym=antibacterial effect	
antimicrobial effect	LABEL=EffectOnBiologicalSystem	ID=DEB_ont.AntimicrobialEffect
antimicrobial	LABEL=EffectOnBiologicalSystem	ID=deb_ont.antimicrobial	PrefSynonym=antimicrobial effect	
antibiotic eluting	LABEL=MedicalApplication	ID=DEB_ont.AntibioticEluting
drug delivery	LABEL=MedicalApplication	ID=DEB_ont.DrugDelivery
drugrelease	LABEL=MedicalApplication	ID=DEB_ont.DrugDelivery	PrefSynonym=drug delivery	
antibiotics	LABEL=BiologicallyActiveSubstance	ID=DEB_ont.Antibiotics
antimycotics	LABEL=BiologicallyActiveSubstance	ID=DEB_ont.Antimycotics
arthroplasty	LABEL=MedicalApplication	ID=DEB_ont.Arthroplasty
tissue reconstruction	LABEL=MedicalApplication	ID=DEB_ont.TissueReconstruction
tissueaugmentation	LABEL=MedicalApplication	ID=DEB_ont.TissueReconstruction	PrefSynonym=tissue reconstruction	
artificial organs	LABEL=MedicalApplication	ID=DEB_ont.ArtificialOrgans
axonal growth	LABEL=AssociatedBiologicalProcess	ID=DEB_ont.AxonalGrowth
cell proliferation	LABEL=AssociatedBiologicalProcess	ID=DEB_ont.CellProliferation
axonal regrowth	LABEL=AssociatedBiologicalProcess	ID=DEB_ont.AxonalRegrowth
BMP	LABEL=BiologicallyActiveSubstance	ID=DEB_ont.BMP
beta glycerolphosphate	LABEL=BiologicallyActiveSubstance	ID=DEB_ont.BetaGlycerolphosphate
bi-layered	LABEL=ManufacturedObjectFeatures	ID=DEB_ont.Bi-layered
bilayer	LABEL=ManufacturedObjectFeatures	ID=DEB_ont.Bilayer
bilayered	LABEL=ManufacturedObjectFeatures	ID=DEB_ont.Bilayered
bioactivity	LABEL=EffectOnBiologicalSystem	ID=DEB_ont.Bioactivity
bioactive	LABEL=EffectOnBiologicalSystem	ID=deb_ont.bioactive	PrefSynonym=bioactivity	
bioceramic	LABEL=BiomaterialType	ID=DEB_ont.Bioceramic
biocompatibility	LABEL=EffectOnBiologicalSystem	ID=DEB_ont.Biocompatibility
biocompatible	LABEL=EffectOnBiologicalSystem	ID=deb_ont.biocompatible	PrefSynonym=biocompatibility	
biocomposite	LABEL=BiomaterialType	ID=DEB_ont.Biocomposite
composite	LABEL=BiomaterialType	ID=DEB_ont.Composite
biodegradability	LABEL=ManufacturedObjectFeatures	ID=DEB_ont.Biodegradability
bioabsorbable	LABEL=ManufacturedObjectFeatures	ID=DEB_ont.Biodegradability	PrefSynonym=biodegradability	
biodegradation	LABEL=ManufacturedObjectFeatures	ID=DEB_ont.Biodegradability	PrefSynonym=biodegradability	
bioresorption	LABEL=ManufacturedObjectFeatures	ID=DEB_ont.Biodegradability	PrefSynonym=biodegradability	
biodegradable	LABEL=ManufacturedObjectFeatures	ID=deb_ont.biodegradable	PrefSynonym=biodegradability	
biofabrication	LABEL=MaterialProcessing	ID=DEB_ont.Biofabrication
biofunctionalization	LABEL=MaterialProcessing	ID=DEB_ont.Biofunctionalization
biofunctional	LABEL=MaterialProcessing	ID=deb_ont.biofunctional	PrefSynonym=biofunctionalization	
functionalization	LABEL=MaterialProcessing	ID=DEB_ont.Functionalization
funcionalized	LABEL=MaterialProcessing	ID=deb_ont.funcionalized	PrefSynonym=functionalization	
biohybrid	LABEL=ManufacturedObjectFeatures	ID=DEB_ont.Biohybrid
bioinertness	LABEL=EffectOnBiologicalSystem	ID=DEB_ont.Bioinertness
biomineralization	LABEL=AssociatedBiologicalProcess	ID=DEB_ont.Biomineralization
mineralized	LABEL=AssociatedBiologicalProcess	ID=deb_ont.mineralized	PrefSynonym=biomineralization	
biopolymer	LABEL=BiomaterialType	ID=DEB_ont.Biopolymer
biostimulatory	LABEL=EffectOnBiologicalSystem	ID=DEB_ont.Biostimulatory
blend	LABEL=BiomaterialType	ID=DEB_ont.Blend
blending	LABEL=MaterialProcessing	ID=DEB_ont.Blending
blended	LABEL=MaterialProcessing	ID=deb_ont.blended	PrefSynonym=blending	
block copolymer	LABEL=BiomaterialType	ID=DEB_ont.BlockCopolymer
copolymer	LABEL=BiomaterialType	ID=DEB_ont.Copolymer
bonding	LABEL=MaterialProcessing	ID=DEB_ont.Bonding
adhesively bonded	LABEL=MaterialProcessing	ID=DEB_ont.Bonding	PrefSynonym=bonding	
bonded	LABEL=MaterialProcessing	ID=DEB_ont.Bonding	PrefSynonym=bonding	
bone cement	LABEL=Biomaterial	ID=DEB_ont.BoneCement
bone healing	LABEL=AssociatedBiologicalProcess	ID=DEB_ont.BoneHealing
bone injury	LABEL=MedicalApplication	ID=DEB_ont.BoneInjury
injury	LABEL=MedicalApplication	ID=DEB_ont.Injury
bony ingrowth	LABEL=AssociatedBiologicalProcess	ID=DEB_ont.BonyIngrowth
braiding	LABEL=MaterialProcessing	ID=DEB_ont.Braiding
braided	LABEL=MaterialProcessing	ID=deb_ont.braided	PrefSynonym=braiding	
bulk modulus	LABEL=ManufacturedObjectFeatures	ID=DEB_ont.BulkModulus
calcium phosphate cement	LABEL=Biomaterial	ID=DEB_ont.CalciumPhosphateCement
cpc	LABEL=Biomaterial	ID=DEB_ont.CalciumPhosphateCement	PrefSynonym=calcium phosphate cement	
cap coating	LABEL=MaterialProcessing	ID=DEB_ont.CapCoating
capillary ingrowth	LABEL=AssociatedBiologicalProcess	ID=DEB_ont.CapillaryIngrowth
capsule	LABEL=Structure	ID=DEB_ont.Capsule
cartilage autograft implantation system	LABEL=ManufacturedObject	ID=DEB_ont.CartilageAutograftImplantationSystem
cartilage injury	LABEL=MedicalApplication	ID=DEB_ont.CartilageInjury
casting	LABEL=MaterialProcessing	ID=DEB_ont.Casting
cell adhesion	LABEL=AssociatedBiologicalProcess	ID=DEB_ont.CellAdhesion
cell attachment	LABEL=AssociatedBiologicalProcess	ID=DEB_ont.CellAdhesion	PrefSynonym=cell adhesion	
cell aggregation	LABEL=AssociatedBiologicalProcess	ID=DEB_ont.CellAggregation
cell colonization	LABEL=AssociatedBiologicalProcess	ID=DEB_ont.CellColonization
cell delivery	LABEL=MedicalApplication	ID=DEB_ont.CellDelivery
cell encapsulation	LABEL=MedicalApplication	ID=DEB_ont.CellEncapsulation
microencapsulated cells	LABEL=MedicalApplication	ID=DEB_ont.CellEncapsulation	PrefSynonym=cell encapsulation	
encapsulation	LABEL=MedicalApplication	ID=DEB_ont.Encapsulation
cell infiltration	LABEL=AssociatedBiologicalProcess	ID=DEB_ont.CellInfiltration
cell migration	LABEL=AssociatedBiologicalProcess	ID=DEB_ont.CellMigration
cell motility	LABEL=AssociatedBiologicalProcess	ID=DEB_ont.CellMotility
cell polarization	LABEL=AssociatedBiologicalProcess	ID=DEB_ont.CellPolarization
cell sheet	LABEL=ManufacturedObjectComponent	ID=DEB_ont.CellSheet
cell viability	LABEL=AssociatedBiologicalProcess	ID=DEB_ont.CellViability
cellular attachment	LABEL=AssociatedBiologicalProcess	ID=DEB_ont.CellularAttachment
cellular differentiation	LABEL=AssociatedBiologicalProcess	ID=DEB_ont.CellularDifferentiation
cell differentiation	LABEL=AssociatedBiologicalProcess	ID=DEB_ont.CellularDifferentiation	PrefSynonym=cellular differentiation	
differentiation	LABEL=AssociatedBiologicalProcess	ID=DEB_ont.CellularDifferentiation	PrefSynonym=cellular differentiation	
cellular infiltration	LABEL=AssociatedBiologicalProcess	ID=DEB_ont.CellularInfiltration
cell infiltration	LABEL=AssociatedBiologicalProcess	ID=DEB_ont.CellularInfiltration	PrefSynonym=cellular infiltration	
cellular spreading	LABEL=AssociatedBiologicalProcess	ID=DEB_ont.CellularSpreading
cell spreading	LABEL=AssociatedBiologicalProcess	ID=DEB_ont.CellularSpreading	PrefSynonym=cellular spreading	
cement	LABEL=ManufacturedObject	ID=DEB_ont.Cement
ceramic	LABEL=BiomaterialType	ID=DEB_ont.Ceramic
chemical formula	LABEL=ManufacturedObjectFeatures	ID=DEB_ont.ChemicalFormula
chemical property	LABEL=ManufacturedObjectFeatures	ID=DEB_ont.ChemicalProperty
chemodrug delivery	LABEL=MedicalApplication	ID=DEB_ont.ChemodrugDelivery
chemotaxis	LABEL=AssociatedBiologicalProcess	ID=DEB_ont.Chemotaxis
chemotactic activity	LABEL=AssociatedBiologicalProcess	ID=DEB_ont.Chemotaxis	PrefSynonym=chemotaxis	
chitosan	LABEL=Biomaterial	ID=DEB_ont.Chitosan
chondrogenic differentiation	LABEL=AssociatedBiologicalProcess	ID=DEB_ont.ChondrogenicDifferentiation
chondrocyte differentiation	LABEL=AssociatedBiologicalProcess	ID=DEB_ont.ChondrogenicDifferentiation	PrefSynonym=chondrogenic differentiation	
chronic inflammation	LABEL=AdverseEffects	ID=DEB_ont.ChronicInflammation
chronic inflammatory changes	LABEL=AdverseEffects	ID=DEB_ont.ChronicInflammation	PrefSynonym=chronic inflammation	
circular	LABEL=ManufacturedObjectFeatures	ID=DEB_ont.Circular
shape	LABEL=ManufacturedObjectFeatures	ID=DEB_ont.Shape
clinical study	LABEL=StudyType	ID=DEB_ont.ClinicalStudy
coat	LABEL=ManufacturedObjectComponent	ID=DEB_ont.Coat
coaxial electrospinning	LABEL=MaterialProcessing	ID=DEB_ont.CoaxialElectrospinning
electrospinning	LABEL=MaterialProcessing	ID=DEB_ont.Electrospinning
electrospun	LABEL=MaterialProcessing	ID=deb_ont.electrospun	PrefSynonym=electrospinning	
collagen	LABEL=BiologicallyActiveSubstance	ID=DEB_ont.Collagen
collagen deposition	LABEL=AssociatedBiologicalProcess	ID=DEB_ont.CollagenDeposition
collagen secretion	LABEL=AssociatedBiologicalProcess	ID=DEB_ont.CollagenSecretion
colloid	LABEL=Structure	ID=DEB_ont.Colloid
colonic surgery	LABEL=MedicalApplication	ID=DEB_ont.ColonicSurgery
comparative	LABEL=StudyType	ID=DEB_ont.Comparative
complications	LABEL=AdverseEffects	ID=DEB_ont.Complications
composite graft	LABEL=ManufacturedObject	ID=DEB_ont.CompositeGraft
surgical implant	LABEL=ManufacturedObject	ID=DEB_ont.SurgicalImplant
implant	LABEL=ManufacturedObject	ID=DEB_ont.SurgicalImplant	PrefSynonym=surgical implant	
compressive modulus	LABEL=ManufacturedObjectFeatures	ID=DEB_ont.CompressiveModulus
compressive strength	LABEL=ManufacturedObjectFeatures	ID=DEB_ont.CompressiveStrength
computational	LABEL=StudyType	ID=DEB_ont.Computational
conditioning	LABEL=MaterialProcessing	ID=DEB_ont.Conditioning
conditioned	LABEL=MaterialProcessing	ID=deb_ont.conditioned	PrefSynonym=conditioning	
conductivity	LABEL=ManufacturedObjectFeatures	ID=DEB_ont.Conductivity
conductive	LABEL=ManufacturedObjectFeatures	ID=deb_ont.conductive	PrefSynonym=conductivity	
contaminated wound	LABEL=AdverseEffects	ID=DEB_ont.ContaminatedWound
continuous suture	LABEL=ManufacturedObject	ID=DEB_ont.ContinuousSuture
core	LABEL=ManufacturedObjectComponent	ID=DEB_ont.Core
corrosion behavior	LABEL=ManufacturedObjectFeatures	ID=DEB_ont.CorrosionBehavior
corrosion	LABEL=ManufacturedObjectFeatures	ID=DEB_ont.CorrosionBehavior	PrefSynonym=corrosion behavior	
corrosion resistance	LABEL=ManufacturedObjectFeatures	ID=DEB_ont.CorrosionResistance
crosslinking	LABEL=MaterialProcessing	ID=DEB_ont.Crosslinking
crosslinked	LABEL=MaterialProcessing	ID=deb_ont.crosslinked	PrefSynonym=crosslinking	
cruciate ligament reconstruction	LABEL=MedicalApplication	ID=DEB_ont.CruciateLigamentReconstruction
cryogel	LABEL=Structure	ID=DEB_ont.Cryogel
cryomilling	LABEL=MaterialProcessing	ID=DEB_ont.Cryomilling
crystal structure	LABEL=ManufacturedObjectFeatures	ID=DEB_ont.CrystalStructure
crystallinity	LABEL=ManufacturedObjectFeatures	ID=DEB_ont.Crystallinity
cube	LABEL=ManufacturedObjectFeatures	ID=DEB_ont.Cube
custom made	LABEL=ManufacturedObjectFeatures	ID=DEB_ont.CustomMade
cylinder	LABEL=ManufacturedObjectFeatures	ID=DEB_ont.Cylinder
cylindrical	LABEL=ManufacturedObjectFeatures	ID=DEB_ont.Cylindrical
cytocompatibility	LABEL=EffectOnBiologicalSystem	ID=DEB_ont.Cytocompatibility
cytocompatible	LABEL=EffectOnBiologicalSystem	ID=deb_ont.cytocompatible	PrefSynonym=cytocompatibility	
cytotoxicity	LABEL=AdverseEffects	ID=DEB_ont.Cytotoxicity
cytotoxic	LABEL=AdverseEffects	ID=deb_ont.cytotoxic	PrefSynonym=cytotoxicity	
decellularization	LABEL=MaterialProcessing	ID=DEB_ont.Decellularization
tissue decellularization	LABEL=MaterialProcessing	ID=DEB_ont.Decellularization	PrefSynonym=decellularization	
decellularized	LABEL=MaterialProcessing	ID=deb_ont.decellularized	PrefSynonym=decellularization	
decellularized extracellular matrix	LABEL=Biomaterial	ID=DEB_ont.DecellularizedExtracellularMatrix
decm	LABEL=Biomaterial	ID=DEB_ont.DecellularizedExtracellularMatrix	PrefSynonym=decellularized extracellular matrix	
decellularized matrix	LABEL=BiomaterialType	ID=DEB_ont.DecellularizedMatrix
deformation	LABEL=ManufacturedObjectFeatures	ID=DEB_ont.Deformation
degradability	LABEL=ManufacturedObjectFeatures	ID=DEB_ont.Degradability
degradation	LABEL=ManufacturedObjectFeatures	ID=DEB_ont.Degradability	PrefSynonym=degradability	
degradable	LABEL=ManufacturedObjectFeatures	ID=deb_ont.degradable	PrefSynonym=degradability	
degradation rate	LABEL=ManufacturedObjectFeatures	ID=DEB_ont.DegradationRate
degradation resistance	LABEL=ManufacturedObjectFeatures	ID=DEB_ont.DegradationResistance
delayed resoption	LABEL=ManufacturedObjectFeatures	ID=DEB_ont.DelayedResoption
demineralized bone matrix	LABEL=BiologicallyActiveSubstance	ID=DEB_ont.DemineralizedBoneMatrix
density	LABEL=ManufacturedObjectFeatures	ID=DEB_ont.Density
deposition	LABEL=MaterialProcessing	ID=DEB_ont.Deposition
diameter	LABEL=ManufacturedObjectFeatures	ID=DEB_ont.Diameter
digestive surgery	LABEL=MedicalApplication	ID=DEB_ont.DigestiveSurgery
disk	LABEL=ManufacturedObjectFeatures	ID=DEB_ont.Disk
distensibility	LABEL=ManufacturedObjectFeatures	ID=DEB_ont.Distensibility
doping	LABEL=MaterialProcessing	ID=DEB_ont.Doping
ductility	LABEL=ManufacturedObjectFeatures	ID=DEB_ont.Ductility
EPTFE	LABEL=Biomaterial	ID=DEB_ont.EPTFE
edema	LABEL=AdverseEffects	ID=DEB_ont.Edema
oedema	LABEL=AdverseEffects	ID=DEB_ont.Edema	PrefSynonym=edema	
electrospraying	LABEL=MaterialProcessing	ID=DEB_ont.Electrospraying
endothelial differentiation	LABEL=AssociatedBiologicalProcess	ID=DEB_ont.EndothelialDifferentiation
endothelialization	LABEL=AssociatedBiologicalProcess	ID=DEB_ont.Endothelialization
engraftment	LABEL=AssociatedBiologicalProcess	ID=DEB_ont.Engraftment
enzymatic treatment	LABEL=MaterialProcessing	ID=DEB_ont.EnzymaticTreatment
epithelialization	LABEL=AssociatedBiologicalProcess	ID=DEB_ont.Epithelialization
epoxy coating	LABEL=MaterialProcessing	ID=DEB_ont.EpoxyCoating
etching	LABEL=MaterialProcessing	ID=DEB_ont.Etching
etched	LABEL=MaterialProcessing	ID=deb_ont.etched	PrefSynonym=etching	
ex vivo	LABEL=StudyType	ID=DEB_ont.ExVivo
extrusion	LABEL=MaterialProcessing	ID=DEB_ont.Extrusion
extruded	LABEL=MaterialProcessing	ID=deb_ont.extruded	PrefSynonym=extrusion	
femoro popliteal bypass	LABEL=MedicalApplication	ID=DEB_ont.FemoroPoplitealBypass
fiber	LABEL=Structure	ID=DEB_ont.Fiber
fibers	LABEL=Structure	ID=DEB_ont.Fiber	PrefSynonym=fiber	
fibre	LABEL=Structure	ID=DEB_ont.Fiber	PrefSynonym=fiber	
fibres	LABEL=Structure	ID=DEB_ont.Fiber	PrefSynonym=fiber	
fibrous	LABEL=Structure	ID=deb_ont.fibrous	PrefSynonym=fiber	
fiber alignment	LABEL=ManufacturedObjectFeatures	ID=DEB_ont.FiberAlignment
fiber diameter	LABEL=ManufacturedObjectFeatures	ID=DEB_ont.FiberDiameter
fibroblast infiltration	LABEL=AssociatedBiologicalProcess	ID=DEB_ont.FibroblastInfiltration
fibroin	LABEL=Biomaterial	ID=DEB_ont.Fibroin
silk	LABEL=Biomaterial	ID=DEB_ont.Silk
fibronectin	LABEL=BiologicallyActiveSubstance	ID=DEB_ont.Fibronectin
fibrotic reaction	LABEL=AdverseEffects	ID=DEB_ont.FibroticReaction
filament	LABEL=Structure	ID=DEB_ont.Filament
film	LABEL=Structure	ID=DEB_ont.Film
flexibility	LABEL=ManufacturedObjectFeatures	ID=DEB_ont.Flexibility
flexible	LABEL=ManufacturedObjectFeatures	ID=deb_ont.flexible	PrefSynonym=flexibility	
foam	LABEL=Structure	ID=DEB_ont.Foam
foaming	LABEL=MaterialProcessing	ID=DEB_ont.Foaming
foamed	LABEL=MaterialProcessing	ID=deb_ont.foamed	PrefSynonym=foaming	
foil	LABEL=Structure	ID=DEB_ont.Foil
foreign body reaction	LABEL=EffectOnBiologicalSystem	ID=DEB_ont.ForeignBodyReaction
foreign body response	LABEL=AdverseEffects	ID=DEB_ont.ForeignBodyResponse
foreign body	LABEL=AdverseEffects	ID=DEB_ont.ForeignBodyResponse	PrefSynonym=foreign body response	
formation of adhesions	LABEL=AdverseEffects	ID=DEB_ont.FormationOfAdhesions
fragmentation	LABEL=ManufacturedObjectFeatures	ID=DEB_ont.Fragmentation
freeze drying	LABEL=MaterialProcessing	ID=DEB_ont.FreezeDrying
freeze-dried	LABEL=MaterialProcessing	ID=DEB_ont.FreezeDrying	PrefSynonym=freeze drying	
freeze-drying	LABEL=MaterialProcessing	ID=DEB_ont.FreezeDrying	PrefSynonym=freeze drying	
gel	LABEL=Structure	ID=DEB_ont.Gel
gelation	LABEL=MaterialProcessing	ID=DEB_ont.Gelation
gelling	LABEL=MaterialProcessing	ID=DEB_ont.Gelling
geometry	LABEL=ManufacturedObjectFeatures	ID=DEB_ont.Geometry
glass	LABEL=BiomaterialType	ID=DEB_ont.Glass
glass-transition temperature	LABEL=ManufacturedObjectFeatures	ID=DEB_ont.Glass-transitionTemperature
glial cell motility	LABEL=AssociatedBiologicalProcess	ID=DEB_ont.GlialCellMotility
glial growth	LABEL=AssociatedBiologicalProcess	ID=DEB_ont.GlialGrowth
glue	LABEL=Structure	ID=DEB_ont.Glue
granule	LABEL=Structure	ID=DEB_ont.Granule
groove	LABEL=ManufacturedObjectFeatures	ID=DEB_ont.Groove
grooved	LABEL=ManufacturedObjectFeatures	ID=DEB_ont.Groove	PrefSynonym=groove	
grooved	LABEL=ManufacturedObjectFeatures	ID=deb_ont.grooved	PrefSynonym=groove	
growth substrate	LABEL=ManufacturedObject	ID=DEB_ont.GrowthSubstrate
substrate	LABEL=ManufacturedObject	ID=DEB_ont.GrowthSubstrate	PrefSynonym=growth substrate	
headache	LABEL=AdverseEffects	ID=DEB_ont.Headache
helical coil	LABEL=ManufacturedObjectFeatures	ID=DEB_ont.HelicalCoil
hematopoietic cell differentiation	LABEL=AssociatedBiologicalProcess	ID=DEB_ont.HematopoieticCellDifferentiation
hemocompatibility	LABEL=EffectOnBiologicalSystem	ID=DEB_ont.Hemocompatibility
heparin	LABEL=BiologicallyActiveSubstance	ID=DEB_ont.Heparin
hepatobiliary surgery	LABEL=MedicalApplication	ID=DEB_ont.HepatobiliarySurgery
hierarchical	LABEL=ManufacturedObjectFeatures	ID=DEB_ont.Hierarchical
histological examination	LABEL=ResearchTechnique	ID=DEB_ont.HistologicalExamination
research technique	LABEL=ResearchTechnique	ID=DEB_ont.ResearchTechnique
histomorphometry	LABEL=ResearchTechnique	ID=DEB_ont.Histomorphometry
histomorphometric examination	LABEL=ResearchTechnique	ID=DEB_ont.Histomorphometry	PrefSynonym=histomorphometry	
human derived matrix	LABEL=BiologicallyActiveSubstance	ID=DEB_ont.HumanDerivedMatrix
hydration	LABEL=MaterialProcessing	ID=DEB_ont.Hydration
hydrated	LABEL=MaterialProcessing	ID=deb_ont.hydrated	PrefSynonym=hydration	
hydrogel	LABEL=Structure	ID=DEB_ont.Hydrogel
hydrogel expander	LABEL=ManufacturedObject	ID=DEB_ont.HydrogelExpander
hydrophilicity	LABEL=ManufacturedObjectFeatures	ID=DEB_ont.Hydrophilicity
hydrophilic	LABEL=ManufacturedObjectFeatures	ID=deb_ont.hydrophilic	PrefSynonym=hydrophilicity	
hydrophobicity	LABEL=ManufacturedObjectFeatures	ID=DEB_ont.Hydrophobicity
hydrophobic	LABEL=ManufacturedObjectFeatures	ID=deb_ont.hydrophobic	PrefSynonym=hydrophobicity	
hydroxyapatite	LABEL=Biomaterial	ID=DEB_ont.Hydroxyapatite
ha	LABEL=Biomaterial	ID=DEB_ont.Hydroxyapatite	PrefSynonym=hydroxyapatite	
hypospadias surgery	LABEL=MedicalApplication	ID=DEB_ont.HypospadiasSurgery
immobilization	LABEL=MaterialProcessing	ID=DEB_ont.Immobilization
immunohistochemistry	LABEL=ResearchTechnique	ID=DEB_ont.Immunohistochemistry
immunohistochemical examination	LABEL=ResearchTechnique	ID=DEB_ont.Immunohistochemistry	PrefSynonym=immunohistochemistry	
immunomodulatory	LABEL=EffectOnBiologicalSystem	ID=DEB_ont.Immunomodulatory
immunologic responses	LABEL=EffectOnBiologicalSystem	ID=DEB_ont.Immunomodulatory	PrefSynonym=immunomodulatory	
immunotoxicological effect	LABEL=AdverseEffects	ID=DEB_ont.ImmunotoxicologicalEffect
impermeability	LABEL=ManufacturedObjectFeatures	ID=DEB_ont.Impermeability
impermeable	LABEL=ManufacturedObjectFeatures	ID=deb_ont.impermeable	PrefSynonym=impermeability	
implant rejection	LABEL=AdverseEffects	ID=DEB_ont.ImplantRejection
rejection of the implant	LABEL=AdverseEffects	ID=DEB_ont.ImplantRejection	PrefSynonym=implant rejection	
implantable cardiovascular device	LABEL=ManufacturedObject	ID=DEB_ont.ImplantableCardiovascularDevice
implantation	LABEL=MedicalApplication	ID=DEB_ont.Implantation
impregnating	LABEL=MaterialProcessing	ID=DEB_ont.Impregnating
impregnation	LABEL=MaterialProcessing	ID=DEB_ont.Impregnating	PrefSynonym=impregnating	
impregnated	LABEL=MaterialProcessing	ID=deb_ont.impregnated	PrefSynonym=impregnating	
in vitro	LABEL=StudyType	ID=DEB_ont.InVitro
in-vitro	LABEL=StudyType	ID=DEB_ont.InVitro	PrefSynonym=in vitro	
in vivo	LABEL=StudyType	ID=DEB_ont.InVivo
in-vivo	LABEL=StudyType	ID=DEB_ont.InVivo	PrefSynonym=in vivo	
interconnected pore network	LABEL=ManufacturedObjectFeatures	ID=DEB_ont.InterconnectedPoreNetwork
pore	LABEL=ManufacturedObjectFeatures	ID=DEB_ont.Pore
interconnectivity	LABEL=ManufacturedObjectFeatures	ID=DEB_ont.Interconnectivity
intraperitoneal onlay mesh	LABEL=MedicalApplication	ID=DEB_ont.IntraperitonealOnlayMesh
ipom	LABEL=MedicalApplication	ID=DEB_ont.IntraperitonealOnlayMesh	PrefSynonym=intraperitoneal onlay mesh	
knitting	LABEL=MaterialProcessing	ID=DEB_ont.Knitting
knitted	LABEL=MaterialProcessing	ID=deb_ont.knitted	PrefSynonym=knitting	
laparoscopic intraperitoneal implantation	LABEL=MedicalApplication	ID=DEB_ont.LaparoscopicIntraperitonealImplantation
lattice	LABEL=Structure	ID=DEB_ont.Lattice
layer	LABEL=ManufacturedObjectComponent	ID=DEB_ont.Layer
layered	LABEL=ManufacturedObjectFeatures	ID=DEB_ont.Layered
layered closure	LABEL=MedicalApplication	ID=DEB_ont.LayeredClosure
life threatening complication	LABEL=AdverseEffects	ID=DEB_ont.LifeThreateningComplication
lipoaspirate fat	LABEL=BiologicallyActiveSubstance	ID=DEB_ont.LipoaspirateFat
load to failure	LABEL=ManufacturedObjectFeatures	ID=DEB_ont.LoadToFailure
luminal obstruction	LABEL=AdverseEffects	ID=DEB_ont.LuminalObstruction
macrophage functional polarization	LABEL=AssociatedBiologicalProcess	ID=DEB_ont.MacrophageFunctionalPolarization
macropore	LABEL=ManufacturedObjectFeatures	ID=DEB_ont.Macropore
macroporous	LABEL=ManufacturedObjectFeatures	ID=deb_ont.macroporous	PrefSynonym=macropore	
macroporosity	LABEL=ManufacturedObjectFeatures	ID=DEB_ont.Macroporosity
porosity	LABEL=ManufacturedObjectFeatures	ID=DEB_ont.Porosity
porous	LABEL=ManufacturedObjectFeatures	ID=deb_ont.porous	PrefSynonym=porosity	
macrotexture	LABEL=ManufacturedObjectFeatures	ID=DEB_ont.Macrotexture
texture	LABEL=ManufacturedObjectFeatures	ID=DEB_ont.Texture
textured	LABEL=ManufacturedObjectFeatures	ID=deb_ont.textured	PrefSynonym=texture	
manufacture	LABEL=MaterialProcessing	ID=DEB_ont.Manufacture
mat	LABEL=Structure	ID=DEB_ont.Mat
material characterization	LABEL=ResearchTechnique	ID=DEB_ont.MaterialCharacterization
matrice	LABEL=Structure	ID=DEB_ont.Matrice
matrices	LABEL=Structure	ID=DEB_ont.Matrice	PrefSynonym=matrice	
matrigel	LABEL=Biomaterial	ID=DEB_ont.Matrigel
matrix deposition	LABEL=AssociatedBiologicalProcess	ID=DEB_ont.MatrixDeposition
matrix synthesis	LABEL=AssociatedBiologicalProcess	ID=DEB_ont.MatrixSynthesis
maximum load	LABEL=ManufacturedObjectFeatures	ID=DEB_ont.MaximumLoad
ultimate strength	LABEL=ManufacturedObjectFeatures	ID=DEB_ont.UltimateStrength
maximum strain	LABEL=ManufacturedObjectFeatures	ID=DEB_ont.MaximumStrain
medical textile	LABEL=ManufacturedObject	ID=DEB_ont.MedicalTextile
membrane	LABEL=Structure	ID=DEB_ont.Membrane
meniscal scaffold	LABEL=ManufacturedObject	ID=DEB_ont.MeniscalScaffold
mesh	LABEL=Structure	ID=DEB_ont.Mesh
mesoporosity	LABEL=ManufacturedObjectFeatures	ID=DEB_ont.Mesoporosity
mesoporous	LABEL=ManufacturedObjectFeatures	ID=deb_ont.mesoporous	PrefSynonym=mesoporosity	
metal	LABEL=BiomaterialType	ID=DEB_ont.Metal
metallic	LABEL=BiomaterialType	ID=deb_ont.metallic	PrefSynonym=metal	
microbead	LABEL=Structure	ID=DEB_ont.Microbead
microcarrier	LABEL=MedicalApplication	ID=DEB_ont.Microcarrier
microfiber	LABEL=Structure	ID=DEB_ont.Microfiber
microfibrous	LABEL=Structure	ID=deb_ont.microfibrous	PrefSynonym=microfiber	
microfibre	LABEL=Structure	ID=DEB_ont.Microfibre
microgel	LABEL=Structure	ID=DEB_ont.Microgel
microgroove	LABEL=ManufacturedObjectFeatures	ID=DEB_ont.Microgroove
microgrooved	LABEL=ManufacturedObjectFeatures	ID=deb_ont.microgrooved	PrefSynonym=microgroove	
microparticle	LABEL=Structure	ID=DEB_ont.Microparticle
microporosity	LABEL=ManufacturedObjectFeatures	ID=DEB_ont.Microporosity
microporous	LABEL=ManufacturedObjectFeatures	ID=deb_ont.microporous	PrefSynonym=microporosity	
microsphere	LABEL=Structure	ID=DEB_ont.Microsphere
microtexture	LABEL=ManufacturedObjectFeatures	ID=DEB_ont.Microtexture
microtextured	LABEL=ManufacturedObjectFeatures	ID=deb_ont.microtextured	PrefSynonym=microtexture	
milling	LABEL=MaterialProcessing	ID=DEB_ont.Milling
milled	LABEL=MaterialProcessing	ID=deb_ont.milled	PrefSynonym=milling	
molar mass	LABEL=ManufacturedObjectFeatures	ID=DEB_ont.MolarMass
molecular structure	LABEL=ManufacturedObjectFeatures	ID=DEB_ont.MolecularStructure
monofilament	LABEL=Structure	ID=DEB_ont.Monofilament
morphology	LABEL=ManufacturedObjectFeatures	ID=DEB_ont.Morphology
multi-layered	LABEL=ManufacturedObjectFeatures	ID=DEB_ont.Multi-layered
multifilament	LABEL=Structure	ID=DEB_ont.Multifilament
polyfilament	LABEL=Structure	ID=DEB_ont.Polyfilament
multilayer	LABEL=ManufacturedObjectFeatures	ID=DEB_ont.Multilayer
multilayered	LABEL=ManufacturedObjectFeatures	ID=DEB_ont.Multilayered
multilineage differentiation	LABEL=AssociatedBiologicalProcess	ID=DEB_ont.MultilineageDifferentiation
myogenic differentiation	LABEL=AssociatedBiologicalProcess	ID=DEB_ont.MyogenicDifferentiation
nanobiocomposite	LABEL=BiomaterialType	ID=DEB_ont.Nanobiocomposite
nanobioglass	LABEL=BiomaterialType	ID=DEB_ont.Nanobioglass
nanocoating	LABEL=MaterialProcessing	ID=DEB_ont.Nanocoating
nanocomposite	LABEL=Structure	ID=DEB_ont.Nanocomposite
nanocrystal	LABEL=Structure	ID=DEB_ont.Nanocrystal
nanoencapsulation	LABEL=MedicalApplication	ID=DEB_ont.Nanoencapsulation
nanofiber	LABEL=Structure	ID=DEB_ont.Nanofiber
nanofibre	LABEL=Structure	ID=DEB_ont.Nanofibre
nanofibrous	LABEL=Structure	ID=deb_ont.nanofibrous	PrefSynonym=nanofibre	
nanohydroxyapetite	LABEL=BiomaterialType	ID=DEB_ont.Nanohydroxyapetite
nanoparticle	LABEL=Structure	ID=DEB_ont.Nanoparticle
nanorod	LABEL=ManufacturedObjectFeatures	ID=DEB_ont.Nanorod
rod	LABEL=ManufacturedObjectFeatures	ID=DEB_ont.Rod
nanoroughness	LABEL=ManufacturedObjectFeatures	ID=DEB_ont.Nanoroughness
nanosphere	LABEL=ManufacturedObjectFeatures	ID=DEB_ont.Nanosphere
sphere	LABEL=ManufacturedObjectFeatures	ID=DEB_ont.Sphere
nanotopography	LABEL=ManufacturedObjectFeatures	ID=DEB_ont.Nanotopography
nanotube	LABEL=Structure	ID=DEB_ont.Nanotube
nanotubular	LABEL=ManufacturedObjectFeatures	ID=DEB_ont.Nanotubular
tubular	LABEL=ManufacturedObjectFeatures	ID=DEB_ont.Tubular
nanowire	LABEL=Structure	ID=DEB_ont.Nanowire
natural material	LABEL=BiomaterialType	ID=DEB_ont.NaturalMaterial
necrosis	LABEL=AdverseEffects	ID=DEB_ont.Necrosis
neocollagenesis	LABEL=AssociatedBiologicalProcess	ID=DEB_ont.Neocollagenesis
neocollagenesis	LABEL=AssociatedBiologicalProcess	ID=DEB_ont.Neocollagenesis	PrefSynonym=neocollagenesis	
neotissue	LABEL=MedicalApplication	ID=DEB_ont.Neotissue
neovascularization	LABEL=AssociatedBiologicalProcess	ID=DEB_ont.Neovascularization
vascularization	LABEL=AssociatedBiologicalProcess	ID=DEB_ont.Vascularization
vascularisation	LABEL=AssociatedBiologicalProcess	ID=DEB_ont.Vascularization	PrefSynonym=vascularization	
network	LABEL=Structure	ID=DEB_ont.Network
neuronal regeneration	LABEL=MedicalApplication	ID=DEB_ont.NeuronalRegeneration
regeneration	LABEL=MedicalApplication	ID=DEB_ont.Regeneration
nodule formation	LABEL=AssociatedBiologicalProcess	ID=DEB_ont.NoduleFormation
non crosslinked	LABEL=ManufacturedObjectFeatures	ID=DEB_ont.NonCrosslinked
non toxic	LABEL=EffectOnBiologicalSystem	ID=DEB_ont.NonToxic
non woven	LABEL=ManufacturedObjectFeatures	ID=DEB_ont.NonWoven
nonabsorbable	LABEL=ManufacturedObjectFeatures	ID=DEB_ont.Nonabsorbable
non-degradable	LABEL=ManufacturedObjectFeatures	ID=DEB_ont.Nonabsorbable	PrefSynonym=nonabsorbable	
nondegradable	LABEL=ManufacturedObjectFeatures	ID=DEB_ont.Nonabsorbable	PrefSynonym=nonabsorbable	
permanent	LABEL=ManufacturedObjectFeatures	ID=deb_ont.permanent	PrefSynonym=nonabsorbable	
nosocomial infection	LABEL=AdverseEffects	ID=DEB_ont.NosocomialInfection
orientation	LABEL=ManufacturedObjectFeatures	ID=DEB_ont.Orientation
oriented	LABEL=ManufacturedObjectFeatures	ID=DEB_ont.Oriented
osseous alterations	LABEL=EffectOnBiologicalSystem	ID=DEB_ont.OsseousAlterations
osteoconductivity	LABEL=AssociatedBiologicalProcess	ID=DEB_ont.Osteoconductivity
osteoconduction	LABEL=AssociatedBiologicalProcess	ID=DEB_ont.Osteoconductivity	PrefSynonym=osteoconductivity	
osteoconductive	LABEL=AssociatedBiologicalProcess	ID=deb_ont.osteoconductive	PrefSynonym=osteoconductivity	
osteogenesis	LABEL=AssociatedBiologicalProcess	ID=DEB_ont.Osteogenesis
osteogenic	LABEL=AssociatedBiologicalProcess	ID=deb_ont.osteogenic	PrefSynonym=osteogenesis	
osteogenic differentiation	LABEL=AssociatedBiologicalProcess	ID=DEB_ont.OsteogenicDifferentiation
osteodifferentiation	LABEL=AssociatedBiologicalProcess	ID=DEB_ont.OsteogenicDifferentiation	PrefSynonym=osteogenic differentiation	
osteogenic induction factors	LABEL=BiologicallyActiveSubstance	ID=DEB_ont.OsteogenicInductionFactors
osteoinduction	LABEL=AssociatedBiologicalProcess	ID=DEB_ont.Osteoinduction
osteoinductivity	LABEL=AssociatedBiologicalProcess	ID=DEB_ont.Osteoinduction	PrefSynonym=osteoinduction	
osteoinductive	LABEL=AssociatedBiologicalProcess	ID=deb_ont.osteoinductive	PrefSynonym=osteoinduction	
osteointegration	LABEL=AssociatedBiologicalProcess	ID=DEB_ont.Osteointegration
PCL	LABEL=Biomaterial	ID=DEB_ont.PCL
PDSII	LABEL=Biomaterial	ID=DEB_ont.PDSII
polydioxanone	LABEL=Biomaterial	ID=DEB_ont.Polydioxanone
pdo	LABEL=Biomaterial	ID=DEB_ont.Polydioxanone	PrefSynonym=polydioxanone	
pds	LABEL=Biomaterial	ID=DEB_ont.Polydioxanone	PrefSynonym=polydioxanone	
pdx	LABEL=Biomaterial	ID=DEB_ont.Polydioxanone	PrefSynonym=polydioxanone	
polidioxanone	LABEL=Biomaterial	ID=DEB_ont.Polydioxanone	PrefSynonym=polydioxanone	
polydioxanon	LABEL=Biomaterial	ID=DEB_ont.Polydioxanone	PrefSynonym=polydioxanone	
p-dioxanone	LABEL=Biomaterial	ID=DEB_ont.Polydioxanone	PrefSynonym=polydioxanone	
poly(dioxanone)	LABEL=Biomaterial	ID=DEB_ont.Polydioxanone	PrefSynonym=polydioxanone	
poly-dioxanone	LABEL=Biomaterial	ID=DEB_ont.Polydioxanone	PrefSynonym=polydioxanone	
PLGA	LABEL=Biomaterial	ID=DEB_ont.PLGA
poly d,l lactic co glycolic acid	LABEL=Biomaterial	ID=DEB_ont.PLGA	PrefSynonym=PLGA	
PLLA	LABEL=Biomaterial	ID=DEB_ont.PLLA
poly-l-lactic-acid	LABEL=Biomaterial	ID=DEB_ont.PLLA	PrefSynonym=PLLA	
poly-l-lactide	LABEL=Biomaterial	ID=DEB_ont.PLLA	PrefSynonym=PLLA	
PMMA	LABEL=Biomaterial	ID=DEB_ont.PMMA
particle	LABEL=Structure	ID=DEB_ont.Particle
patch	LABEL=ManufacturedObject	ID=DEB_ont.Patch
pepsin treatment	LABEL=MaterialProcessing	ID=DEB_ont.PepsinTreatment
perforation	LABEL=MaterialProcessing	ID=DEB_ont.Perforation
perforated	LABEL=MaterialProcessing	ID=deb_ont.perforated	PrefSynonym=perforation	
periodontal surgery	LABEL=MedicalApplication	ID=DEB_ont.PeriodontalSurgery
photocrosslinking	LABEL=MaterialProcessing	ID=DEB_ont.Photocrosslinking
photocrosslinked	LABEL=MaterialProcessing	ID=deb_ont.photocrosslinked	PrefSynonym=photocrosslinking	
pin	LABEL=ManufacturedObject	ID=DEB_ont.Pin
plasma treatment	LABEL=MaterialProcessing	ID=DEB_ont.PlasmaTreatment
plasma_treated	LABEL=MaterialProcessing	ID=deb_ont.plasma_treated	PrefSynonym=plasma treatment	
platelet rich plasma	LABEL=BiologicallyActiveSubstance	ID=DEB_ont.PlateletRichPlasma
prp	LABEL=BiologicallyActiveSubstance	ID=DEB_ont.PlateletRichPlasma	PrefSynonym=platelet rich plasma	
polishing	LABEL=MaterialProcessing	ID=DEB_ont.Polishing
polished	LABEL=MaterialProcessing	ID=deb_ont.polished	PrefSynonym=polishing	
poly-p-dioxanone	LABEL=Biomaterial	ID=DEB_ont.Poly-p-dioxanone
ppdo	LABEL=Biomaterial	ID=DEB_ont.Poly-p-dioxanone	PrefSynonym=poly-p-dioxanone	
polyethylene terephthalate	LABEL=Biomaterial	ID=DEB_ont.PolyethyleneTerephthalate
dacron	LABEL=Biomaterial	ID=DEB_ont.PolyethyleneTerephthalate	PrefSynonym=polyethylene terephthalate	
polyethyleneglycol	LABEL=Biomaterial	ID=DEB_ont.Polyethyleneglycol
peg	LABEL=Biomaterial	ID=DEB_ont.Polyethyleneglycol	PrefSynonym=polyethyleneglycol	
polyglactin910	LABEL=Biomaterial	ID=DEB_ont.Polyglactin910
pg910	LABEL=Biomaterial	ID=DEB_ont.Polyglactin910	PrefSynonym=polyglactin910	
polyglycolic acid	LABEL=Biomaterial	ID=DEB_ont.PolyglycolicAcid
dexon	LABEL=Biomaterial	ID=DEB_ont.PolyglycolicAcid	PrefSynonym=polyglycolic acid	
pga	LABEL=Biomaterial	ID=DEB_ont.PolyglycolicAcid	PrefSynonym=polyglycolic acid	
polylacticacid	LABEL=Biomaterial	ID=DEB_ont.Polylacticacid
pla	LABEL=Biomaterial	ID=DEB_ont.Polylacticacid	PrefSynonym=polylacticacid	
poly lactic acid	LABEL=Biomaterial	ID=DEB_ont.Polylacticacid	PrefSynonym=polylacticacid	
poly(d,l-lactic acid)	LABEL=Biomaterial	ID=DEB_ont.Polylacticacid	PrefSynonym=polylacticacid	
polylevolactide	LABEL=Biomaterial	ID=DEB_ont.Polylevolactide
polylysine	LABEL=Biomaterial	ID=DEB_ont.Polylysine
polymer	LABEL=BiomaterialType	ID=DEB_ont.Polymer
polymers	LABEL=BiomaterialType	ID=DEB_ont.Polymer	PrefSynonym=polymer	
polymeric	LABEL=BiomaterialType	ID=DEB_ont.Polymer	PrefSynonym=polymer	
polymeric	LABEL=BiomaterialType	ID=deb_ont.polymeric	PrefSynonym=polymer	
polymerization	LABEL=MaterialProcessing	ID=DEB_ont.Polymerization
polymerized	LABEL=MaterialProcessing	ID=deb_ont.polymerized	PrefSynonym=polymerization	
polytetrafluoroethylene	LABEL=Biomaterial	ID=DEB_ont.Polytetrafluoroethylene
ptfe	LABEL=Biomaterial	ID=DEB_ont.Polytetrafluoroethylene	PrefSynonym=polytetrafluoroethylene	
teflon	LABEL=Biomaterial	ID=DEB_ont.Polytetrafluoroethylene	PrefSynonym=polytetrafluoroethylene	
pore size	LABEL=ManufacturedObjectFeatures	ID=DEB_ont.PoreSize
postoperative adhesion	LABEL=AdverseEffects	ID=DEB_ont.PostoperativeAdhesion
powder	LABEL=Structure	ID=DEB_ont.Powder
powdered	LABEL=Structure	ID=deb_ont.powdered	PrefSynonym=powder	
pre clinical study	LABEL=StudyType	ID=DEB_ont.PreClinicalStudy
precoating	LABEL=MaterialProcessing	ID=DEB_ont.Precoating
precoated	LABEL=MaterialProcessing	ID=deb_ont.precoated	PrefSynonym=precoating	
preconditioning	LABEL=MaterialProcessing	ID=DEB_ont.Preconditioning
preconditioned	LABEL=MaterialProcessing	ID=deb_ont.preconditioned	PrefSynonym=preconditioning	
printing	LABEL=MaterialProcessing	ID=DEB_ont.Printing
proliferation	LABEL=AssociatedBiologicalProcess	ID=DEB_ont.Proliferation
prospective	LABEL=StudyType	ID=DEB_ont.Prospective
prospective multi center trial	LABEL=StudyType	ID=DEB_ont.ProspectiveMultiCenterTrial
prosthetic patch	LABEL=ManufacturedObject	ID=DEB_ont.ProstheticPatch
pull out strength	LABEL=ManufacturedObjectFeatures	ID=DEB_ont.PullOutStrength
purification	LABEL=MaterialProcessing	ID=DEB_ont.Purification
RGD	LABEL=BiologicallyActiveSubstance	ID=DEB_ont.RGD
radial compressive strength	LABEL=ManufacturedObjectFeatures	ID=DEB_ont.RadialCompressiveStrength
radial compression strength	LABEL=ManufacturedObjectFeatures	ID=DEB_ont.RadialCompressiveStrength	PrefSynonym=radial compressive strength	
re-endothelization	LABEL=AssociatedBiologicalProcess	ID=DEB_ont.Re-endothelization
recoarctation	LABEL=AdverseEffects	ID=DEB_ont.Recoarctation
recombinant human bone morphogenetic protein	LABEL=BiologicallyActiveSubstance	ID=DEB_ont.RecombinantHumanBoneMorphogeneticProtein
rhbmp	LABEL=BiologicallyActiveSubstance	ID=DEB_ont.RecombinantHumanBoneMorphogeneticProtein	PrefSynonym=recombinant human bone morphogenetic protein	
reinforcement	LABEL=MaterialProcessing	ID=DEB_ont.Reinforcement
reinforced	LABEL=MaterialProcessing	ID=deb_ont.reinforced	PrefSynonym=reinforcement	
reinnervation	LABEL=AssociatedBiologicalProcess	ID=DEB_ont.Reinnervation
re-innervation	LABEL=AssociatedBiologicalProcess	ID=DEB_ont.Reinnervation	PrefSynonym=reinnervation	
repair of skull	LABEL=MedicalApplication	ID=DEB_ont.RepairOfSkull
resorption	LABEL=ManufacturedObjectFeatures	ID=DEB_ont.Resorption
resorbable	LABEL=ManufacturedObjectFeatures	ID=deb_ont.resorbable	PrefSynonym=resorption	
resurfacing	LABEL=MaterialProcessing	ID=DEB_ont.Resurfacing
retinal detachment	LABEL=AdverseEffects	ID=DEB_ont.RetinalDetachment
retrospective	LABEL=StudyType	ID=DEB_ont.Retrospective
retrospective analysis	LABEL=StudyType	ID=DEB_ont.RetrospectiveAnalysis
retrospective study	LABEL=StudyType	ID=DEB_ont.RetrospectiveStudy
revascularization	LABEL=AssociatedBiologicalProcess	ID=DEB_ont.Revascularization
ring	LABEL=ManufacturedObjectFeatures	ID=DEB_ont.Ring
roughening	LABEL=MaterialProcessing	ID=DEB_ont.Roughening
roughened	LABEL=MaterialProcessing	ID=deb_ont.roughened	PrefSynonym=roughening	
sandblasting	LABEL=MaterialProcessing	ID=DEB_ont.Sandblasting
sandblasted	LABEL=MaterialProcessing	ID=deb_ont.sandblasted	PrefSynonym=sandblasting	
scaffold mineralization	LABEL=AssociatedBiologicalProcess	ID=DEB_ont.ScaffoldMineralization
scanning electron microscopy	LABEL=ResearchTechnique	ID=DEB_ont.ScanningElectronMicroscopy
sem	LABEL=ResearchTechnique	ID=DEB_ont.ScanningElectronMicroscopy	PrefSynonym=scanning electron microscopy	
screw	LABEL=ManufacturedObject	ID=DEB_ont.Screw
secondary infection	LABEL=AdverseEffects	ID=DEB_ont.SecondaryInfection
self assembling	LABEL=ManufacturedObjectFeatures	ID=DEB_ont.SelfAssembling
self-assembling	LABEL=ManufacturedObjectFeatures	ID=DEB_ont.SelfAssembling	PrefSynonym=self assembling	
semipermeablity	LABEL=ManufacturedObjectFeatures	ID=DEB_ont.Semipermeablity
semi-permeable	LABEL=ManufacturedObjectFeatures	ID=DEB_ont.Semipermeablity	PrefSynonym=semipermeablity	
semipermeable	LABEL=ManufacturedObjectFeatures	ID=deb_ont.semipermeable	PrefSynonym=semipermeablity	
septoplasty	LABEL=MedicalApplication	ID=DEB_ont.Septoplasty
sheet	LABEL=Structure	ID=DEB_ont.Sheet
shell	LABEL=ManufacturedObjectComponent	ID=DEB_ont.Shell
shell-core	LABEL=Structure	ID=DEB_ont.Shell-core
si r n a	LABEL=BiologicallyActiveSubstance	ID=DEB_ont.SiRNA
siderophore	LABEL=BiologicallyActiveSubstance	ID=DEB_ont.Siderophore
sintering	LABEL=MaterialProcessing	ID=DEB_ont.Sintering
sintered	LABEL=MaterialProcessing	ID=deb_ont.sintered	PrefSynonym=sintering	
size	LABEL=ManufacturedObjectFeatures	ID=DEB_ont.Size
skin closure	LABEL=MedicalApplication	ID=DEB_ont.SkinClosure
skin irritation	LABEL=AdverseEffects	ID=DEB_ont.SkinIrritation
small caliber	LABEL=ManufacturedObjectFeatures	ID=DEB_ont.SmallCaliber
small-caliber	LABEL=ManufacturedObjectFeatures	ID=DEB_ont.SmallCaliber	PrefSynonym=small caliber	
sol-gel	LABEL=MaterialProcessing	ID=DEB_ont.Sol-gel
solâ€“gel method	LABEL=MaterialProcessing	ID=DEB_ont.Sol-gel	PrefSynonym=sol-gel	
solvent casting	LABEL=MaterialProcessing	ID=DEB_ont.SolventCasting
spheroid	LABEL=ManufacturedObjectFeatures	ID=DEB_ont.Spheroid
spidroin	LABEL=Biomaterial	ID=DEB_ont.Spidroin
spiral	LABEL=ManufacturedObjectFeatures	ID=DEB_ont.Spiral
sponge	LABEL=Structure	ID=DEB_ont.Sponge
spongy	LABEL=Structure	ID=deb_ont.spongy	PrefSynonym=sponge	
spring	LABEL=ManufacturedObjectFeatures	ID=DEB_ont.Spring
sputtering	LABEL=MaterialProcessing	ID=DEB_ont.Sputtering
stent insertion	LABEL=MedicalApplication	ID=DEB_ont.StentInsertion
stiffness	LABEL=ManufacturedObjectFeatures	ID=DEB_ont.Stiffness
surface functionalization	LABEL=MaterialProcessing	ID=DEB_ont.SurfaceFunctionalization
surface hydrophilicity	LABEL=ManufacturedObjectFeatures	ID=DEB_ont.SurfaceHydrophilicity
surface roughness	LABEL=ManufacturedObjectFeatures	ID=DEB_ont.SurfaceRoughness
surface topography	LABEL=ManufacturedObjectFeatures	ID=DEB_ont.SurfaceTopography
surgical repair	LABEL=MedicalApplication	ID=DEB_ont.SurgicalRepair
suture	LABEL=ManufacturedObject	ID=DEB_ont.Suture
synethtic polymer	LABEL=BiomaterialType	ID=DEB_ont.SynethticPolymer
synthetic material	LABEL=BiomaterialType	ID=DEB_ont.SyntheticMaterial
tendon healing	LABEL=MedicalApplication	ID=DEB_ont.TendonHealing
tenogenic differentiation	LABEL=AssociatedBiologicalProcess	ID=DEB_ont.TenogenicDifferentiation
tensile strength	LABEL=ManufacturedObjectFeatures	ID=DEB_ont.TensileStrength
textile	LABEL=Structure	ID=DEB_ont.Textile
thermal behaviour	LABEL=ManufacturedObjectFeatures	ID=DEB_ont.ThermalBehaviour
thermal decomposition temperature	LABEL=ManufacturedObjectFeatures	ID=DEB_ont.ThermalDecompositionTemperature
thermally induced phase separation	LABEL=MaterialProcessing	ID=DEB_ont.ThermallyInducedPhaseSeparation
thermocycling	LABEL=MaterialProcessing	ID=DEB_ont.Thermocycling
thermogel	LABEL=Structure	ID=DEB_ont.Thermogel
thickness	LABEL=ManufacturedObjectFeatures	ID=DEB_ont.Thickness
thin film	LABEL=Structure	ID=DEB_ont.ThinFilm
thread	LABEL=Structure	ID=DEB_ont.Thread
ti-6 al-4 v	LABEL=Biomaterial	ID=DEB_ont.Ti-6Al-4V
tissue integration	LABEL=EffectOnBiologicalSystem	ID=DEB_ont.TissueIntegration
tissue regeneration	LABEL=MedicalApplication	ID=DEB_ont.TissueRegeneration
titanium	LABEL=Biomaterial	ID=DEB_ont.Titanium
topology	LABEL=ManufacturedObjectFeatures	ID=DEB_ont.Topology
toughness	LABEL=ManufacturedObjectFeatures	ID=DEB_ont.Toughness
toxicity	LABEL=AdverseEffects	ID=DEB_ont.Toxicity
toxic	LABEL=AdverseEffects	ID=deb_ont.toxic	PrefSynonym=toxicity	
tripolymer	LABEL=BiomaterialType	ID=DEB_ont.Tripolymer
tube	LABEL=Structure	ID=DEB_ont.Tube
tubes	LABEL=Structure	ID=DEB_ont.Tube	PrefSynonym=tube	
two-layered closure	LABEL=MedicalApplication	ID=DEB_ont.Two-layeredClosure
type i collagen	LABEL=BiologicallyActiveSubstance	ID=DEB_ont.TypeICollagen
collagen (type i)	LABEL=BiologicallyActiveSubstance	ID=DEB_ont.TypeICollagen	PrefSynonym=type i collagen	
ultimate tensile strength	LABEL=ManufacturedObjectFeatures	ID=DEB_ont.UltimateTensileStrength
unidirectional	LABEL=ManufacturedObjectFeatures	ID=DEB_ont.Unidirectional
vocal fold augmentation	LABEL=MedicalApplication	ID=DEB_ont.VocalFoldAugmentation
weaving	LABEL=MaterialProcessing	ID=DEB_ont.Weaving
woven	LABEL=MaterialProcessing	ID=deb_ont.woven	PrefSynonym=weaving	
wettability	LABEL=ManufacturedObjectFeatures	ID=DEB_ont.Wettability
wire	LABEL=Structure	ID=DEB_ont.Wire
wound abscesses	LABEL=AdverseEffects	ID=DEB_ont.WoundAbscesses
wound dressing	LABEL=MedicalApplication	ID=DEB_ont.WoundDressing
wound healing	LABEL=MedicalApplication	ID=DEB_ont.WoundHealing
wrapped	LABEL=ManufacturedObjectFeatures	ID=DEB_ont.Wrapped
yarn	LABEL=Structure	ID=DEB_ont.Yarn
bioprinting	LABEL=MaterialProcessing	ID=DEB_ont.bioprinting
bioprinted	LABEL=MaterialProcessing	ID=deb_ont.bioprinted	PrefSynonym=bioprinting	
nanostructure	LABEL=Structure	ID=DEB_ont.nanostructure
nanostructured	LABEL=Structure	ID=deb_ont.nanostructured	PrefSynonym=nanostructure	
osteogenicity	LABEL=EffectOnBiologicalSystem	ID=DEB_ont.osteogenicity
2- layer	LABEL=Structure	ID=DEB_ont.2-Layer
3 d printing	LABEL=MaterialProcessing	ID=DEB_ont.3DPrinting
three dimensional printing	LABEL=MaterialProcessing	ID=DEB_ont.3DPrinting	PrefSynonym=3 d printing	
3d_printed	LABEL=MaterialProcessing	ID=deb_ont.3d_printed	PrefSynonym=3 d printing	
poly(glycolide-co-epsilon-caprolactone)	LABEL=Biomaterial	ID=DEB_ont.Poly(glycolide-co-epsilon-caprolactone)
pgacl	LABEL=Biomaterial	ID=DEB_ont.Poly(glycolide-co-epsilon-caprolactone)	PrefSynonym=poly(glycolide-co-epsilon-caprolactone)	
poly(glycolide:lactide)	LABEL=Biomaterial	ID=DEB_ont.Poly(glycolide:lactide)
plga	LABEL=Biomaterial	ID=DEB_ont.Poly(glycolide:lactide)	PrefSynonym=poly(glycolide:lactide)	
poly(vinyl_alcohol)	LABEL=Biomaterial	ID=DEB_ont.Poly(vinyl_alcohol)
pva	LABEL=Biomaterial	ID=DEB_ont.Poly(vinyl_alcohol)	PrefSynonym=poly(vinyl_alcohol)	
poly vinyl alcohol	LABEL=Biomaterial	ID=DEB_ont.Poly(vinyl_alcohol)	PrefSynonym=poly(vinyl_alcohol)	
young's modulus	LABEL=ManufacturedObjectFeatures	ID=DEB_ont.Young'sModulus
