TGF beta	LABEL=Cell
Palatal Muscles	LABEL=Tissue
Sphenoid Bone	LABEL=Tissue
Flexor pollicis longus	LABEL=Tissue
interleukin 24	LABEL=Cell
Osteon	LABEL=Tissue
ESEM	LABEL=ResearchTechnique
Epidermal growth factor from Human urine	LABEL=Cell
Costal tubercle	LABEL=Tissue
NRG1	LABEL=Cell
Bi-articular muscle	LABEL=Tissue
CCL9	LABEL=Cell
TGP-3	LABEL=Cell
Mastoid air cells	LABEL=Tissue
Chemokine CCL19	LABEL=Cell
Zygoma	LABEL=Tissue
Bones of Lower Extremity	LABEL=Tissue
ciliary muscle	LABEL=Tissue
Femoropatellar Articulation	LABEL=Tissue
muscle of trunk	LABEL=Tissue
Resistin	LABEL=Cell
Elbow Joint	LABEL=Tissue
B-lymphocyte chemoattractant protein	LABEL=Cell
FGF-7	LABEL=Cell
Abductor pollicis longus muscle tendon	LABEL=Tissue
Bones of Upper Extremity	LABEL=Tissue
Respiratory Muscles	LABEL=Tissue
IL-23p19	LABEL=Cell
Thrombopoietin	LABEL=Cell
Interferon Alfa-2c	LABEL=Cell
IL-18	LABEL=Cell
cucullaris muscle	LABEL=Tissue
Occipital Bone	LABEL=Tissue
Laryngeal Muscles	LABEL=Tissue
hip abductor	LABEL=Tissue
Femur Neck	LABEL=Tissue
optical microscope	LABEL=ResearchTechnique
phalanx	LABEL=Tissue
leg bone	LABEL=Tissue
Brachioradialis muscle	LABEL=Tissue
Cribriform fascia	LABEL=Tissue
chest	LABEL=Tissue
Jaw	LABEL=Tissue
Capitate Bone	LABEL=Tissue
Muscles of Pharynx	LABEL=Tissue
CM joint	LABEL=Tissue
IL-21	LABEL=Cell
Lymphotoxin-alpha	LABEL=Cell
Gracilis tendon	LABEL=Tissue
Interferon-gamma, Recombinant	LABEL=Cell
Subchondral bone	LABEL=Tissue
MTP joint	LABEL=Tissue
Patellar Ligament	LABEL=Tissue
Toe Joint	LABEL=Tissue
CCL1	LABEL=Cell
energy-filtering transmission electron microscope	LABEL=ResearchTechnique
Human bone	LABEL=Tissue
Bone and Bones	LABEL=Tissue
Erythropoietin, Recombinant	LABEL=Cell
Bone microstructure	LABEL=Tissue
CCL11	LABEL=Cell
Papillary Muscles	LABEL=Tissue
IFN gamma	LABEL=Cell
extensor carpi radialis brevis muscle	LABEL=Tissue
Abdomen Rectus Muscle	LABEL=Tissue
Granulocyte Colony Stimulating Factor, Recombinant	LABEL=Cell
MCPJ	LABEL=Tissue
Eye Socket	LABEL=Tissue
Cartilage matrix	LABEL=Tissue
Flat pelvic contour	LABEL=Tissue
Synchondroses sternales	LABEL=Tissue
Th2 cytokine	LABEL=Cell
muscle of upper extremity	LABEL=Tissue
Flexor digitorum profundus muscle	LABEL=Tissue
BTB	LABEL=Tissue
apophyseal joint	LABEL=Tissue
Hyoid Bone	LABEL=Tissue
Os Trapezoideum	LABEL=Tissue
Mullerian muscle	LABEL=Tissue
lumbrical muscle	LABEL=Tissue
Ischium	LABEL=Tissue
Vastus lateralis muscle	LABEL=Tissue
Elastic Cartilage	LABEL=Tissue
Triceps	LABEL=Tissue
SCF	LABEL=Cell
shinbone	LABEL=Tissue
Growth Plate	LABEL=Tissue
IF-alpha 2	LABEL=Cell
EGF	LABEL=Cell
APRIL	LABEL=Cell
Nasal Cartilage	LABEL=Tissue
TNFリガンドスーパーファミリー13	LABEL=Cell
Broad Ligament	LABEL=Tissue
Little finger abductor	LABEL=Tissue
Articulatio humeroradialis	LABEL=Tissue
Supraspinatus muscle	LABEL=Tissue
LIF	LABEL=Cell
conch	LABEL=Tissue
Tendons	LABEL=Tissue
Os Pisiforme	LABEL=Tissue
PDGF-AA	LABEL=Cell
CXCL2	LABEL=Cell
cryogenic transmission electron microscope	LABEL=ResearchTechnique
Palmar Plate	LABEL=Tissue
Costal Cartilage	LABEL=Tissue
Spinal Canal	LABEL=Tissue
Muscles	LABEL=Tissue
Glisson sphincter	LABEL=Tissue
CINC	LABEL=Cell
Flt3 ligand	LABEL=Cell
Triangular Fibrocartilage	LABEL=Tissue
Atrial muscle	LABEL=Tissue
B cell- and monocyte-activating chemokine	LABEL=Cell
Hip muscle	LABEL=Tissue
epiphyseal line	LABEL=Tissue
PDGF	LABEL=Cell
IL-1 beta	LABEL=Cell
Velopharyngeal Sphincter	LABEL=Tissue
exogenous	LABEL=Tissue
IGF	LABEL=Cell
Masticatory Muscles	LABEL=Tissue
Atlanto-axial spine	LABEL=Tissue
Scapulothoracic joint	LABEL=Tissue
darbepoetin alfa	LABEL=Cell
Tarsal Joints	LABEL=Tissue
Trabecular bone	LABEL=Tissue
Esophageal Sphincter, Lower	LABEL=Tissue
CCL5	LABEL=Cell
Medial Meniscus	LABEL=Tissue
Acromioclavicular Joint	LABEL=Tissue
Aditus ad antrum	LABEL=Tissue
Corrugator supercilii muscle	LABEL=Tissue
Deltoid Muscle	LABEL=Tissue
cryo-EM	LABEL=ResearchTechnique
Frontal Bone	LABEL=Tissue
Bony Callus	LABEL=Tissue
Interleukin-12 Subunit p40	LABEL=Cell
Oculomotor Muscle	LABEL=Tissue
beta thromboglobulin	LABEL=Cell
Proximal phalanx	LABEL=Tissue
Intervertebral Disc	LABEL=Tissue
Finger PIP joint	LABEL=Tissue
CXC chemokine	LABEL=Cell
Arytenoid Cartilage	LABEL=Tissue
Interleukin 1 Receptor Antagonist Protein	LABEL=Cell
Leg Bone	LABEL=Tissue
Thoracic Vertebrae	LABEL=Tissue
IFN-tau	LABEL=Cell
Esophageal Sphincter, Upper	LABEL=Tissue
betacellulin	LABEL=Cell
Ilium	LABEL=Tissue
Plantar muscle	LABEL=Tissue
Patella	LABEL=Tissue
articular disc	LABEL=Tissue
TL1A	LABEL=Cell
Atlanto Axial Joint	LABEL=Tissue
crural muscle	LABEL=Tissue
Laryngeal Cartilages	LABEL=Tissue
calcaneus	LABEL=Tissue
Sella Turcica	LABEL=Tissue
IL-12p70	LABEL=Cell
shoulder muscle	LABEL=Tissue
Mastoid	LABEL=Tissue
Medullary bone	LABEL=Tissue
Interossei muscle	LABEL=Tissue
Carpal Joint	LABEL=Tissue
Nucleus Pulposus	LABEL=Tissue
IL-10	LABEL=Cell
biological microscope	LABEL=ResearchTechnique
MIG	LABEL=Cell
Neurturin	LABEL=Cell
Maxilla	LABEL=Tissue
PEG-INF-alpha-2b	LABEL=Cell
Purkinje Fibers	LABEL=Tissue
4-1BB Ligand	LABEL=Cell
Tooth Component	LABEL=Tissue
Xiphoid Bone	LABEL=Tissue
MIP-2	LABEL=Cell
Knee Joint	LABEL=Tissue
FGF-10	LABEL=Cell
CCL3	LABEL=Cell
transmission electron microscope	LABEL=ResearchTechnique
eye of scallop	LABEL=Tissue
Inhibins	LABEL=Cell
Myocardium	LABEL=Tissue
slit lamp microscope	LABEL=ResearchTechnique
Temporomandibular Joint	LABEL=Tissue
Superior cervical spine	LABEL=Tissue
Medial head of gastrocnemius muscle	LABEL=Tissue
Anterior Cranial Fossa	LABEL=Tissue
Latissimus dorsi	LABEL=Tissue
Vomer	LABEL=Tissue
Tendon of palmaris longus muscle	LABEL=Tissue
Epiphyses	LABEL=Tissue
Atlas	LABEL=Tissue
oyster shell	LABEL=Tissue
GMF	LABEL=Cell
Gluteus maximus	LABEL=Tissue
Lunate Bone	LABEL=Tissue
PDGF-BB	LABEL=Cell
IL-2	LABEL=Cell
Distal phalanx	LABEL=Tissue
Medial patellofemoral ligament	LABEL=Tissue
Rotator Cuff	LABEL=Tissue
TNF alpha	LABEL=Cell
Collateral Ligament	LABEL=Tissue
Parietal	LABEL=Tissue
IFN-alpha 2b	LABEL=Cell
IL-7	LABEL=Cell
Semitendinosus muscle	LABEL=Tissue
Flexor tendon	LABEL=Tissue
LIGHT	LABEL=Cell
Bones of Feet	LABEL=Tissue
CT 1	LABEL=Cell
Bones of Hands	LABEL=Tissue
Auricular Cartilage	LABEL=Tissue
CXCL8	LABEL=Cell
Wrist Joint	LABEL=Tissue
IL-9	LABEL=Cell
passive joint	LABEL=Tissue
ODF	LABEL=Cell
Foramen Magnum	LABEL=Tissue
Lymphotoxin alpha1, beta2 Heterotrimer	LABEL=Cell
Adipokine	LABEL=Cell
Tendons, Para-Articular	LABEL=Tissue
leptin	LABEL=Cell
IL-31	LABEL=Cell
KC	LABEL=Cell
Meniscus	LABEL=Tissue
os palatinum	LABEL=Tissue
TNFリガンドスーパーファミリー14	LABEL=Cell
Stapedius	LABEL=Tissue
specular microscope	LABEL=ResearchTechnique
Radioulnar synostosis	LABEL=Tissue
Fas Ligand Protein	LABEL=Cell
Transversus abdominis muscle	LABEL=Tissue
Facial Bones	LABEL=Tissue
Fas ligand	LABEL=Cell
interleukin 19	LABEL=Cell
confocal microscope	LABEL=ResearchTechnique
vaspin	LABEL=Cell
Th1 cytokine	LABEL=Cell
Buccinator muscle	LABEL=Tissue
Muscle, Skeletal	LABEL=Tissue
Dentition	LABEL=Tissue
Hamstring	LABEL=Tissue
FGF18	LABEL=Cell
IL-1	LABEL=Cell
cancellous bone	LABEL=Tissue
IGF-1	LABEL=Cell
CSF39-300	LABEL=Cell
Pelvic Bones	LABEL=Tissue
muscle of shoulder	LABEL=Tissue
CX3C chemokine	LABEL=Cell
Hand Joints	LABEL=Tissue
CSF-1	LABEL=Cell
Tibialis posterior muscle	LABEL=Tissue
heparin-binding growth factor	LABEL=Cell
Subtalar Joint	LABEL=Tissue
Flaval Ligament	LABEL=Tissue
IL-16	LABEL=Cell
Darbepoetin	LABEL=Cell
Multifidus muscle	LABEL=Tissue
FGF20	LABEL=Cell
Greater trochanter	LABEL=Tissue
Clavicle	LABEL=Tissue
Hamate Bone	LABEL=Tissue
Bone tunnel	LABEL=Tissue
anti-inflammatory cytokine	LABEL=Cell
TNF beta	LABEL=Cell
TFCC	LABEL=Tissue
CXCL12	LABEL=Cell
Ligament	LABEL=Tissue
Interferon Type I, Recombinant	LABEL=Cell
Radius	LABEL=Tissue
inhibin B	LABEL=Cell
CXC chemokine IP-10	LABEL=Cell
IL-22	LABEL=Cell
IFN alfacon 1	LABEL=Cell
Granulocyte Macrophage Colony-Stimulating Factors, Recombinant	LABEL=Cell
TGF alpha	LABEL=Cell
scanning electron microscope	LABEL=ResearchTechnique
KRN-8601	LABEL=Cell
Epiglottis	LABEL=Tissue
circular muscle	LABEL=Tissue
FGF5	LABEL=Cell
TGF beta 1	LABEL=Cell
IL-17	LABEL=Cell
visfatin	LABEL=Cell
Articulationes pedis	LABEL=Tissue
distal end of radius	LABEL=Tissue
iliac muscle	LABEL=Tissue
Fascia	LABEL=Tissue
CINC-1	LABEL=Cell
B cell stimulatory factor 2	LABEL=Cell
tendinous synovium	LABEL=Tissue
alveolar bone	LABEL=Tissue
Pubic Symphyses	LABEL=Tissue
Mandible	LABEL=Tissue
cultured periosteum sheet	LABEL=Tissue
Sternocostal Joint	LABEL=Tissue
Whale bone	LABEL=Tissue
Abdominal Muscle	LABEL=Tissue
CXCL5	LABEL=Cell
Atlanto Occipital Joint	LABEL=Tissue
CX3CL1	LABEL=Cell
Meckel cartilage	LABEL=Tissue
CC chemokine	LABEL=Cell
Pro-inflammatory cytokine	LABEL=Cell
Fibrous ring	LABEL=Tissue
Animal Carpus	LABEL=Tissue
Fascia Lata	LABEL=Tissue
Subscapularis muscle	LABEL=Tissue
TGF beta 3	LABEL=Cell
IL-27	LABEL=Cell
Longissimus lumbar muscle	LABEL=Tissue
Fiblast spray	LABEL=Cell
FGF21	LABEL=Cell
Membrana Synovialis Capsulae Articularis	LABEL=Tissue
Ectodysplasins	LABEL=Cell
PDGF-B	LABEL=Cell
Odontoid Process	LABEL=Tissue
decalcified bone matrix	LABEL=Tissue
iliopsoas muscle	LABEL=Tissue
frame (structure)	LABEL=Tissue
IL-1 alpha	LABEL=Cell
Spinous process of vertebra	LABEL=Tissue
Neck Muscle	LABEL=Tissue
FGF-1	LABEL=Cell
Periosteum	LABEL=Tissue
CCL27	LABEL=Cell
eotaxin	LABEL=Cell
Cranial Fossa, Middle	LABEL=Tissue
Monokines	LABEL=Cell
Achilles tendon	LABEL=Tissue
Temporal Bone	LABEL=Tissue
Metatarsal Bones	LABEL=Tissue
Colony-Stimulating Factors, Recombinant	LABEL=Cell
Fish bone	LABEL=Tissue
CCL20	LABEL=Cell
Triceps brachii	LABEL=Tissue
Thyroid Cartilage	LABEL=Tissue
Lymphokines	LABEL=Cell
Interferon Type I	LABEL=Cell
mitogenic factor	LABEL=Cell
Petrous Bone	LABEL=Tissue
IFN-beta	LABEL=Cell
Finger Joint	LABEL=Tissue
Nasal Bone	LABEL=Tissue
MIP-1	LABEL=Cell
Suprahyoid muscles	LABEL=Tissue
Abdominal oblique muscle	LABEL=Tissue
Temporal Muscle Fascia	LABEL=Tissue
Quadriceps Femoris	LABEL=Tissue
Joint lip	LABEL=Tissue
Astragalus Bones	LABEL=Tissue
immuno-fluorescence microscope	LABEL=ResearchTechnique
Os Triquetrum	LABEL=Tissue
neonatal bone	LABEL=Tissue
lumbar facet joint	LABEL=Tissue
Epoetin beta	LABEL=Cell
CCL18	LABEL=Cell
Shoulder Joint	LABEL=Tissue
IL-13	LABEL=Cell
NGF	LABEL=Cell
Diaphragm	LABEL=Tissue
FGF19	LABEL=Cell
Cervical Vertebrae	LABEL=Tissue
FGF6	LABEL=Cell
HMW adiponectin	LABEL=Cell
musculus soleus	LABEL=Tissue
L-spine	LABEL=Tissue
FGF	LABEL=Cell
Synovial Fluid	LABEL=Tissue
Ventricular muscle	LABEL=Tissue
foramen	LABEL=Tissue
CXCL9	LABEL=Cell
Arm Bone	LABEL=Tissue
Diaphyses	LABEL=Tissue
FGF-9	LABEL=Cell
FGF-2	LABEL=Cell
extensor digitorum longus	LABEL=Tissue
CCL25	LABEL=Cell
Cytokines	LABEL=Cell
Hyaline Cartilage	LABEL=Tissue
Chemokine CCL24	LABEL=Cell
TNF	LABEL=Cell
GITRL	LABEL=Cell
Skull	LABEL=Tissue
sartorius muscle	LABEL=Tissue
Medial Collateral Ligament, Knee	LABEL=Tissue
stereoscopic microscope	LABEL=ResearchTechnique
Anal sphincter	LABEL=Tissue
FPI-31	LABEL=Cell
Cartilage	LABEL=Tissue
Alveolar Process	LABEL=Tissue
leg muscle	LABEL=Tissue
Interferon beta-1b	LABEL=Cell
CCL8	LABEL=Cell
Peroneus longus muscle	LABEL=Tissue
Femorotibial joint	LABEL=Tissue
vertebra	LABEL=Tissue
Coccyx	LABEL=Tissue
Triceps surae muscle	LABEL=Tissue
Coracoid Process	LABEL=Tissue
CCL17	LABEL=Cell
Chemokine CCL22	LABEL=Cell
PEG-IFN	LABEL=Cell
Skull Base	LABEL=Tissue
Dentition, Primary	LABEL=Tissue
Patellar tendon	LABEL=Tissue
TSLP	LABEL=Cell
Back and lumbar muscle	LABEL=Tissue
flexor	LABEL=Tissue
MAF	LABEL=Cell
Posterior Cruciate Ligament	LABEL=Tissue
extensor	LABEL=Tissue
Chemokine CCL21	LABEL=Cell
fluorescence microscope	LABEL=ResearchTechnique
CCL2	LABEL=Cell
Femoral head	LABEL=Tissue
Os Trapezium	LABEL=Tissue
Skeleton	LABEL=Tissue
Chemokines	LABEL=Cell
Muscle Fibers, Skeletal	LABEL=Tissue
masseter	LABEL=Tissue
Infraspinatus muscle	LABEL=Tissue
Musculoskeletal System	LABEL=Tissue
G-CSF	LABEL=Cell
Antagonist muscle	LABEL=Tissue
carapace	LABEL=Tissue
Intrinsic muscle	LABEL=Tissue
Sacroiliac Joint	LABEL=Tissue
Interferon Alfa-2a	LABEL=Cell
FGF3	LABEL=Cell
I-TAC	LABEL=Cell
TGF beta 2	LABEL=Cell
Mandibular Condyle	LABEL=Tissue
Spinal Columns	LABEL=Tissue
Ulna	LABEL=Tissue
Upper arm muscle	LABEL=Tissue
Ethmoid Bone	LABEL=Tissue
IL-25	LABEL=Cell
Sternum	LABEL=Tissue
GDF-8	LABEL=Cell
Sternoclavicular Joint	LABEL=Tissue
inhibin A	LABEL=Cell
Ribs	LABEL=Tissue
Femur	LABEL=Tissue
Joints	LABEL=Tissue
concha nasalis inferior	LABEL=Tissue
Conchae Nasale	LABEL=Tissue
IFN-alpha	LABEL=Cell
External urinary canal sphincter muscle	LABEL=Tissue
IL-32	LABEL=Cell
vasohibin	LABEL=Cell
TNFリガンドスーパーファミリー15	LABEL=Cell
Hamstring tendon	LABEL=Tissue
Carpal Bones	LABEL=Tissue
Temporomandibular Articular Disc	LABEL=Tissue
Dentition, Mixed	LABEL=Tissue
TYB-5220	LABEL=Cell
Axis	LABEL=Tissue
muscle of head	LABEL=Tissue
Round Ligament	LABEL=Tissue
Cranial Fontanel	LABEL=Tissue
External anal sphincter muscle	LABEL=Tissue
Piriformis muscle	LABEL=Tissue
CXCL11	LABEL=Cell
Bone tissue	LABEL=Tissue
KRN-5702	LABEL=Cell
DIP関節	LABEL=Tissue
Mandibular canal	LABEL=Tissue
Temporal Muscle	LABEL=Tissue
Gordon reflex	LABEL=Tissue
Tensor Tympani	LABEL=Tissue
Anterior Cruciate Ligament	LABEL=Tissue
Pelvic Floor	LABEL=Tissue
gastrocnemius	LABEL=Tissue
microscope	LABEL=ResearchTechnique
Cartilage, Articular	LABEL=Tissue
Middle phalanx	LABEL=Tissue
Chemokine CXCL6	LABEL=Cell
EPO	LABEL=Cell
Nonsuppressible Insulin-Like Activity	LABEL=Cell
Paravertebral muscle	LABEL=Tissue
constrictor	LABEL=Tissue
Femoral neck	LABEL=Tissue
Biceps femoris muscle	LABEL=Tissue
OX40 Ligand	LABEL=Cell
IL-15	LABEL=Cell
Digastric muscle	LABEL=Tissue
GDF-15	LABEL=Cell
recessus sphenoethmoidalis	LABEL=Tissue
Radio-ulnar joint	LABEL=Tissue
Manubrium	LABEL=Tissue
Rectus femoris muscle	LABEL=Tissue
Autobone	LABEL=Tissue
Suprahyoid muscle	LABEL=Tissue
Scaphoid Bone	LABEL=Tissue
forearm bone	LABEL=Tissue
Chemokine CX3CL1	LABEL=Cell
Sacrum	LABEL=Tissue
CXCL16	LABEL=Cell
Scapula	LABEL=Tissue
CCL-21 chemokine	LABEL=Cell
Spinal facet joint	LABEL=Tissue
Proximal femoral bone	LABEL=Tissue
anococcygeus muscle	LABEL=Tissue
Pectoralis Muscles	LABEL=Tissue
Metacarpal Bones	LABEL=Tissue
tendon transplant	LABEL=Tissue
FGF-4	LABEL=Cell
Long bone	LABEL=Tissue
Peritendineum	LABEL=Tissue
TNF-Related Apoptosis-Inducing Ligand	LABEL=Cell
Bone structure	LABEL=Tissue
Carpometacarpal interosseous joint	LABEL=Tissue
detrusor	LABEL=Tissue
Epoetin Alfa	LABEL=Cell
fibula	LABEL=Tissue
Ilio-tibial band	LABEL=Tissue
Toe Phalanges	LABEL=Tissue
S-6820	LABEL=Cell
MCP-3	LABEL=Cell
amphiregulin	LABEL=Cell
Mm.thoracis superficiales	LABEL=Tissue
CCL4	LABEL=Cell
Tendon of the long head of biceps	LABEL=Tissue
Pronator quadratus muscle	LABEL=Tissue
Abdominal internal oblique muscle	LABEL=Tissue
IL-12	LABEL=Cell
flight muscle	LABEL=Tissue
MIF	LABEL=Cell
Intercostal Muscles	LABEL=Tissue
Rhomboid muscle	LABEL=Tissue
Vertebral body	LABEL=Tissue
IL-33	LABEL=Cell
peri-implant bone	LABEL=Tissue
Finger Phalanges	LABEL=Tissue
IL-12p35	LABEL=Cell
IL-17F	LABEL=Cell
Levator ani muscle	LABEL=Tissue
Back Muscles	LABEL=Tissue
extraocular muscles	LABEL=Tissue
Chemokine CCL3	LABEL=Cell
Hip Joint	LABEL=Tissue
Levator palpebrae superioris muscle	LABEL=Tissue
Erector spinae	LABEL=Tissue
muscle of thigh	LABEL=Tissue
greater psoas muscle	LABEL=Tissue
Mother of pearl	LABEL=Tissue
Semitendinous tendon	LABEL=Tissue
Bone Matrix	LABEL=Tissue
Humerus	LABEL=Tissue
Hard Palates	LABEL=Tissue
Calvaria	LABEL=Tissue
Flexor digitorum superficialis tendon	LABEL=Tissue
Ankle Lateral Ligaments	LABEL=Tissue
MIP-1 beta	LABEL=Cell
PDGF-A	LABEL=Cell
sternocleidomastoid muscle	LABEL=Tissue
IFN	LABEL=Cell
visceral muscle	LABEL=Tissue
longissimus dorsi	LABEL=Tissue
Cranial Fossa, Posterior	LABEL=Tissue
Popliteal pterygium syndrome	LABEL=Tissue
migration inhibition factor	LABEL=Cell
Semimembranosus muscle	LABEL=Tissue
Chemokine CCL20	LABEL=Cell
Pubic Bone	LABEL=Tissue
Thenar muscle	LABEL=Tissue
greater pectoral muscle	LABEL=Tissue
IL-14	LABEL=Cell
articulationes interphalangeae	LABEL=Tissue
Haversian System	LABEL=Tissue
Extensor  tendon	LABEL=Tissue
Bundle of His	LABEL=Tissue
operating microscope	LABEL=ResearchTechnique
Acetabular roof	LABEL=Tissue
Extensor pollicis longus muscle tendon	LABEL=Tissue
IL-5	LABEL=Cell
Synovial fringe	LABEL=Tissue
FGF-23	LABEL=Cell
SR-PSOX	LABEL=Cell
Interferon beta-1a	LABEL=Cell
Abductor pollicis brevis muscle	LABEL=Tissue
Lymphotoxin-beta	LABEL=Cell
epiregulin	LABEL=Cell
Shortened dental arch	LABEL=Tissue
Gluteus medius muscle	LABEL=Tissue
Cranial Sutures	LABEL=Tissue
C chemokine	LABEL=Cell
First dorsal interosseous muscle	LABEL=Tissue
Fibrocartilage	LABEL=Tissue
Tibialis anterior muscle	LABEL=Tissue
OCIF	LABEL=Cell
IL-17A	LABEL=Cell
Abdominal external oblique muscle	LABEL=Tissue
electron microscope	LABEL=ResearchTechnique
TGF	LABEL=Cell
Orbicularis oris muscle	LABEL=Tissue
Bone graft	LABEL=Tissue
Humerus medullary cavity	LABEL=Tissue
Serratus anterior muscle	LABEL=Tissue
Acetabulum	LABEL=Tissue
CCL22	LABEL=Cell
IGF-2	LABEL=Cell
30 kDa adipocyte complement related protein	LABEL=Cell
Filgrastim	LABEL=Cell
IL-12p40	LABEL=Cell
adductor muscle	LABEL=Tissue
CSF	LABEL=Cell
Sesamoid Bones	LABEL=Tissue
Jaw muscle	LABEL=Tissue
B cell differentiating factor	LABEL=Cell
Cricoid Cartilage	LABEL=Tissue
Osteopontin	LABEL=Cell
IL-11	LABEL=Cell
Facial Muscles	LABEL=Tissue
annular ligament	LABEL=Tissue
Epidural Space	LABEL=Tissue
Articular Ligament	LABEL=Tissue
Ankle Joint	LABEL=Tissue
FGF-8	LABEL=Cell
Oral peripheral muscle	LABEL=Tissue
Suppressor Factors, Immunologic	LABEL=Cell
IL-23	LABEL=Cell
Pterygoid Muscle	LABEL=Tissue
orbicular muscle of eye	LABEL=Tissue
minor psoas muscle	LABEL=Tissue
Longitudinal Ligament	LABEL=Tissue
Cortical Bone	LABEL=Tissue
Chemokine CCL17	LABEL=Cell
II type interferon	LABEL=Cell
Thoracic longissimus muscle	LABEL=Tissue
Vastus medialis muscle	LABEL=Tissue
Biceps brachii	LABEL=Tissue
Chemokine CCL7	LABEL=Cell
Frontal muscle	LABEL=Tissue
Forearm muscle	LABEL=Tissue
CCL19	LABEL=Cell
Lamina dura	LABEL=Tissue
Tarsal Bones	LABEL=Tissue
IL-3	LABEL=Cell
B cell-activating factor belonging to the TNF family	LABEL=Cell
Distal radioulnar joint	LABEL=Tissue
Oncostatin M	LABEL=Cell
Special muscle	LABEL=Tissue
IL	LABEL=Cell
Lingual muscle	LABEL=Tissue
PEG interferon alpha 2a	LABEL=Cell
lymphotoxin	LABEL=Cell
Alveolus Dentali	LABEL=Tissue
Dentition, Permanent	LABEL=Tissue
CXCL1	LABEL=Cell
MCP	LABEL=Cell
Acromion	LABEL=Tissue
Cervical Rib	LABEL=Tissue
Pasteurized autogenous bone	LABEL=Tissue
Pterygopalatine Fossa	LABEL=Tissue
chemerin	LABEL=Cell
Lumbar multifidus muscle	LABEL=Tissue
Th17 cytokine	LABEL=Cell
FLIM	LABEL=ResearchTechnique
myotrophin	LABEL=Cell
inflammatory chemokine	LABEL=Cell
vasohibin 1	LABEL=Cell
FGF15	LABEL=Cell
dental microscope	LABEL=ResearchTechnique
immunofluorescence microscopy	LABEL=ResearchTechnique
Olecranon Process	LABEL=Tissue
PDGF-C	LABEL=Cell
Lefty	LABEL=Cell
b-FGF preparation	LABEL=Cell
Ro-50-3821	LABEL=Cell
rotator interval	LABEL=Tissue
iliocostal muscle	LABEL=Tissue
thoraco-lumbar junction	LABEL=Tissue
pore in shell	LABEL=Tissue
recombinant canine interferon gamma	LABEL=Cell
left ventricular cardiac muscle	LABEL=Tissue
articular space	LABEL=Tissue
Humeral Head	LABEL=Tissue
inguinal ligament	LABEL=Tissue
Myokine	LABEL=Cell
IFN-lambda	LABEL=Cell
Clivus	LABEL=Tissue
levator muscle of velum palatinum	LABEL=Tissue
bursa subacromialis	LABEL=Tissue
Supraspinatus tendon	LABEL=Tissue
musculus semispinalis cervicis	LABEL=Tissue
arcus dentalis superior	LABEL=Tissue
periscapular muscle	LABEL=Tissue
jaw closing muscles	LABEL=Tissue
pronator teres muscle	LABEL=Tissue
inverted microscope	LABEL=ResearchTechnique
Lesser Pelvis	LABEL=Tissue
pelvic floor muscle	LABEL=Tissue
Distal radius	LABEL=Tissue
musculus tensor fasciae latae	LABEL=Tissue
pedicle of arch of a vertebra	LABEL=Tissue
Cavitas pelvis	LABEL=Tissue
hock	LABEL=Tissue
artificial finger joint	LABEL=Tissue
condyle of the femur	LABEL=Tissue
articular cartilage of the knee	LABEL=Tissue
ankle plantar flexion muscle	LABEL=Tissue
flexor digitorum superficialis	LABEL=Tissue
mandibular ramus	LABEL=Tissue
anterior cranial base	LABEL=Tissue
lumbar disc	LABEL=Tissue
TNFSF15	LABEL=Cell
plantar flexion muscle	LABEL=Tissue
postero-lateral bundle	LABEL=Tissue
extensor digitorum longus	LABEL=Tissue
body of maxilla	LABEL=Tissue
flexor carpi radialis muscle	LABEL=Tissue
articulatio talocruralis	LABEL=Tissue
IL-20	LABEL=Cell
dural canal	LABEL=Tissue
perimysia	LABEL=Tissue
Accessory Atrioventricular Bundle	LABEL=Tissue
fibular collateral ligament	LABEL=Tissue
flexor pollicis longus muscle tendon	LABEL=Tissue
myocardiac tissue	LABEL=Tissue
musculus pectoralis minor	LABEL=Tissue
knee joint muscle	LABEL=Tissue
thoraco-lumbar spine	LABEL=Tissue
anteromedial bundle	LABEL=Tissue
Musculus teres minor	LABEL=Tissue
capitulum of humerus	LABEL=Tissue
musculus sternohyoideus	LABEL=Tissue
IL28B	LABEL=Cell
vertebral endplate	LABEL=Tissue
Glenoid Cavity	LABEL=Tissue
anterior talofibular ligament	LABEL=Tissue
subscapularis muscle tendon	LABEL=Tissue
scallop shell	LABEL=Tissue
cuboid	LABEL=Tissue
bone cortex	LABEL=Tissue
lateral abdominal muscle	LABEL=Tissue
calcaneofibular ligament	LABEL=Tissue
deep digital flexor tendon	LABEL=Tissue
abductor hallucis muscle	LABEL=Tissue
pegfilgrastim	LABEL=Cell
knee flexor tendon	LABEL=Tissue
muscle-tendon complex	LABEL=Tissue
knee extensor	LABEL=Tissue
abductor pollicis muscle	LABEL=Tissue
IL-35	LABEL=Cell
Biceps tendon	LABEL=Tissue
Paraspinal Muscles	LABEL=Tissue
Intermediate Back Muscles	LABEL=Tissue
Superficial Back Muscles	LABEL=Tissue
artificial urinary sphincter	LABEL=Tissue
bone head	LABEL=Tissue
epoetin	LABEL=Cell
jiont stability	LABEL=Tissue
cytokine profile	LABEL=Cell
Flexor hallucis longus muscle	LABEL=Tissue
Epigen	LABEL=Cell
EGF Family of Proteins	LABEL=Cell
flexor hallucis longus muscle tendon	LABEL=Tissue
obturatorius internus muscle	LABEL=Tissue
Plantar Plate	LABEL=Tissue
bony union	LABEL=Tissue
peroneus	LABEL=Tissue
humeral head retroversion	LABEL=Tissue
Round Ligament of Femur	LABEL=Tissue
coracoclavicular ligament	LABEL=Tissue
vastus intermedius muscle	LABEL=Tissue
intelectin-1	LABEL=Cell
Superficial Musculoaponeurotic System	LABEL=Tissue
Round Ligaments	LABEL=Tissue
CERA	LABEL=Cell
epoetin kappa	LABEL=Cell
Treitz's ligament	LABEL=Tissue
